11111111111
1P000000001
1000C000001
1000000C0E1
11111111111