11111111111111111111111111111111111
10P011100000000000C000000C100010001
100011100000000C0000000111100000101
100000000100000001000000000000001E1
11111111111100000100000000111111111
1C01110000000010C001110000000001C01
1000000100011111110001C000000000001
10000100000000000111000001000000001
10000100000000000011000000000000001
1000110000000000000C000000000000001
10011000000000000000000000000000001
11111111111111111111111111111111111