11111111111
1P000000001
1000C000001
1000001C1E1
11111111111