11111111111
1P000000001
1000C000011
100000001E1
11111111111